1,1,1,1,1,1,1,1,1,1
1,0,0,0,0,0,0,0,0,1
1,21,0,11,0,0,0,0,0,1
1,1,1,1,0,0,20,0,0,1
1,1,1,1,1,1,1,1,1,1
1,0,0,0,0,0,0,0,0,1
1,0,0,0,0,0,0,0,0,1
1,0,0,0,0,0,0,0,0,1
1,0,0,0,0,0,0,0,0,1
1,1,1,1,1,1,1,1,1,1
