1,1,1,1,1,1,1,1,1,1
1,0,0,0,0,0,0,0,0,1
1,2,2,0,0,0,0,20,0,1
1,2,2,1,1,1,1,1,1,1
1,2,2,0,0,0,0,0,0,1
1,2,2,0,0,21,0,0,0,1
1,1,1,1,1,1,1,1,1,1
1,0,0,0,0,0,0,0,0,1
1,0,0,0,0,0,0,0,0,1
1,1,1,1,1,1,1,1,1,1
