1,1,1,1,1,1,1,1,1,1
1,0,0,0,0,0,0,0,0,1
1,0,0,0,0,0,0,0,0,1
1,0,0,0,0,0,0,0,0,1
1,0,0,0,0,0,0,0,0,1
1,0,0,0,0,0,0,0,0,1
1,0,0,21,0,0,0,0,0,1
1,1,1,1,1,0,11,0,20,1
1,1,1,1,1,1,1,1,1,1
1,1,1,1,1,1,1,1,1,1
