1,1,1,1,1,1,1,1,1,1
1,0,0,0,0,0,0,0,0,1
1,0,0,0,0,0,0,0,0,1
1,0,0,2,2,0,20,0,0,1
1,0,0,2,2,1,1,1,1,1
1,0,0,2,2,0,0,0,0,1
1,0,0,2,2,0,0,0,0,1
1,0,0,2,2,0,0,0,0,1
1,0,21,2,2,0,11,0,0,1
1,1,1,1,1,1,1,1,1,1
