1,1,1,1,1,1,1,1,1,1
1,0,0,0,0,0,0,0,0,1
1,20,0,2,2,0,0,0,0,1
1,1,1,2,2,0,0,0,0,1
1,0,0,2,2,0,0,0,0,1
1,0,0,2,2,0,2,2,0,1
1,1,1,1,1,1,2,2,1,1
1,0,0,0,0,0,2,2,0,1
1,21,0,11,0,0,2,2,0,1
1,1,1,1,1,1,1,1,1,1
